N ./textures/north.png 
SO ./textures/south.png
WE ./textures/west.png   
E ./textures/east.png   

F 128,128,128
C 28,188,232


1111111111111111
100000000001111 
1000000000000001
1000000000000001
10000000000000S1
1000000000000001
1000000000000001
1111111111111111


   
