N ./textures/north.png 
SO ./textures/south.png
WE ./textures/west.png   
E ./textures/east.png   

F 220,100,0
C 100,100,0

1
1111111111111111111111111
1000000000110000000000001
101100000111000000000001
10010000000000000000000111111111
11111111101100N001110000000000001
100000000011000001110111111111111
11110111111111011100000010001
11110111111111011101010010001
11000000110101011100000010001
1000000000000100000010000111
1000100000000001101010010001
110000011101010111110111100111
11110111 1110101 101111010001
11111111 1111111 111111111111    
1111111111111111111111111
100000000110000000000001
101100000111000000000001
10010000000000000000000111111111
111111111011000001110000000000001
100000000011000001110111111111111
11110111111111011100000010001
11110111111111011101010010001
11000000110101011100000010001
1000000000000100000010000111
1000100000000001101010010001
110000011101010111110111100111
11110111 1110101 101111010001
11111111 1111111 111111111111